OOOOOOOOOO
OOOOOOOOOO
##########
#O   X X #
#      # #
#E   C C #
######  b#
OOOOO#####
OOOOOOOOOO
OOOOOOOOOO
