##########
#    X   #
# O      #
###%%#####
#b    C  #
#  C     #
#   ggggX#
#   ######
#E t#t m #
##########