OOOOOOOOOO
O#########
O#XX X  b#
O# #     #
O#C  #####
O#  C  O #
O# C     #
O#  E    #
O#########
OOOOOOOOOO

