##########
#b  X   X#
#        #
#    C   #
#  p     #
#     P# #
#  C   #C#
#     O# #
#  X   #E#
##########
